seq_id,level_0,level_1,level_2
seq_A1,L0_C000001,L1_N000001,L2_N000001
seq_A2,L0_C000001,L1_N000001,L2_N000001
seq_A3,L0_C000001,L1_N000001,L2_N000001
seq_B1,L0_C000002,L1_N000002,L2_N000001
seq_B2,L0_C000002,L1_N000002,L2_N000001
seq_B3,L0_C000002,L1_N000002,L2_N000001
seq_C1,L0_C000003,L1_N000003,L2_N000002
seq_C2,L0_C000003,L1_N000003,L2_N000002
seq_C3,L0_C000003,L1_N000003,L2_N000002
seq_D1,L0_C000004,L1_N000004,L2_N000003
seq_D2,L0_C000004,L1_N000004,L2_N000003
